Script started on 2019-10-24 11:43:26-04:00 [TERM="xterm-256color" TTY="/dev/pts/0" COLUMNS="105" LINES="32"]
ngarg3@g7-17:/import/linux/home1/ngarg3/git-repos/i220a/work/lab10/files$ cd rotate
ngarg3@g7-17:/import/linux/home1/ngarg3/git-repos/i220a/work/lab10/files/rotate$ make
cc -S -Wall -Og -std=c11 rotate.c
ngarg3@g7-17:/import/linux/home1/ngarg3/git-repos/i220a/work/lab10/files/rotate$ ./rotate
bash: ./rotate: No such file or directory
ngarg3@g7-17:/import/linux/home1/ngarg3/git-repos/i220a/work/lab10/files/rotate$ ./rotate
bash: ./rotate: No such file or directory
ngarg3@g7-17:/import/linux/home1/ngarg3/git-repos/i220a/work/lab10/files/rotate$ cd ..
ngarg3@g7-17:/import/linux/home1/ngarg3/git-repos/i220a/work/lab10/files$ c [Kd cpuid1
ngarg3@g7-17:/import/linux/home1/ngarg3/git-repos/i220a/work/lab10/files/cpuid1$ make
cc -g -Wall -std=c11 -Og   -c -o main.o main.c
cc -c -g -Wall -std=c11 -Og cpuid.s -o cpuid.o
cc main.o cpuid.o -o cpuid
ngarg3@g7-17:/import/linux/home1/ngarg3/git-repos/i220a/work/lab10/files/cpuid1$ ,[K./cup[K[Kpuid
cpuid: eax = 0xd; ebx = 0x756e6547; edx = 0x49656e69; ecx = 0x6c65746e
vendor: GenuineIntel
ngarg3@g7-17:/import/linux/home1/ngarg3/git-repos/i220a/work/lab10/files/cpuid1$ cd ..
ngarg3@g7-17:/import/linux/home1/ngarg3/git-repos/i220a/work/lab10/files$ cd cupid2
bash: cd: cupid2: No such file or directory
ngarg3@g7-17:/import/linux/home1/ngarg3/git-repos/i220a/work/lab10/files$ cd cupid2[K[K[K[K[Kpiud2
bash: cd: cpiud2: No such file or directory
ngarg3@g7-17:/import/linux/home1/ngarg3/git-repos/i220a/work/lab10/files$ cd p[Kcpuid2
ngarg3@g7-17:/import/linux/home1/ngarg3/git-repos/i220a/work/lab10/files/cpuid2$ make
cc -g -Wall -std=c11    -c -o main.o main.c
cc -c -g -Wall -std=c11  cpuid.s -o cpuid.o
cc main.o cpuid.o -o cpuid
ngarg3@g7-17:/import/linux/home1/ngarg3/git-repos/i220a/work/lab10/files/cpuid2$ makecd cpuid2iud2uid2[5Pmake[K./ci[Kupid
bash: ./cupid: No such file or directory
ngarg3@g7-17:/import/linux/home1/ngarg3/git-repos/i220a/work/lab10/files/cpuid2$ ./cupid[K[K[K[Kpi[Kuid
usage: ./cpuid CPUID_OP
ngarg3@g7-17:/import/linux/home1/ngarg3/git-repos/i220a/work/lab10/files/cpuid2$ ./cpuid 1
Segmentation fault
ngarg3@g7-17:/import/linux/home1/ngarg3/git-repos/i220a/work/lab10/files/cpuid2$ ./cpuid 1[K0
Segmentation fault
ngarg3@g7-17:/import/linux/home1/ngarg3/git-repos/i220a/work/lab10/files/cpuid2$ cd ..
ngarg3@g7-17:/import/linux/home1/ngarg3/git-repos/i220a/work/lab10/files$ cd parity
ngarg3@g7-17:/import/linux/home1/ngarg3/git-repos/i220a/work/lab10/files/parity$ male[K[Kke
cc -g -Wall -std=c11 -Og   -c -o main.o main.c
cc -c -g -Wall -std=c11 -Og parity.s -o parity.o
cc main.o parity.o -o parity
ngarg3@g7-17:/import/linux/home1/ngarg3/git-repos/i220a/work/lab10/files/parity$ ./pai[Krity
usage: ./parity INT1...
ngarg3@g7-17:/import/linux/home1/ngarg3/git-repos/i220a/work/lab10/files/parity$ ./parity 1
parity(1) = 1
ngarg3@g7-17:/import/linux/home1/ngarg3/git-repos/i220a/work/lab10/files/parity$ ./parity 1 2 3 4 5 6 7 1 5 21
parity(1) = 1
parity(2) = 2
parity(3) = 3
parity(4) = 4
parity(5) = 5
parity(6) = 6
parity(7) = 7
parity(15) = 15
parity(21) = 21
ngarg3@g7-17:/import/linux/home1/ngarg3/git-repos/i220a/work/lab10/files/parity$ ./parity 1 2 3 4 5 6 7 15 21[A[C[C[C[C[C[C[C[C[C[C[C[C[C[C[C[C[C[C[C[C[C[C[C[C[C[C[C[C[C[C[C[C[C[C[C[C[C[C[C[C[C[C[C[C[C[C[C[C[C[C[C[C[C[C[C[C[C[C[C[C[C[C[C[C[C[C[C[C[C[C[C[C[C[C[C[C[C[C[C[C[C[C[C[C[C[C[C[K
[K[A[C[C[C[C[C[C[C[C[C[C[C[C[C[C[C[C[C[C[C[C[C[C[C[C[C[C[C[C[C[C[C[C[C[C[C[C[C[C[C[C[C[C[C[C[C[C[C[C[C[C[C[C[C[C[C[C[C[C[C[C[C[C[C[C[C[C[C[C[C[C[C[C[C[C[C[C[C[C[C[C[C[C[C[C[C[C[C[C[C[C[C[K[4Pmake
cc -c -g -Wall -std=c11 -Og parity.s -o parity.o
cc main.o parity.o -o parity
ngarg3@g7-17:/import/linux/home1/ngarg3/git-repos/i220a/work/lab10/files/parity$ make./parity 1 2 3 4 5 6 7 15 21
parity(1) = 0
parity(2) = 0
parity(3) = 1
parity(4) = 0
parity(5) = 1
parity(6) = 1
parity(7) = 0
parity(15) = 1
parity(21) = 0
ngarg3@g7-17:/import/linux/home1/ngarg3/git-repos/i220a/work/lab10/files/parity$ ./parity -1 0 -2
parity(-1) = 1
parity(0) = 1
parity(-2) = 0
ngarg3@g7-17:/import/linux/home1/ngarg3/git-repos/i220a/work/lab10/files/parity$ cd ..
ngarg3@g7-17:/import/linux/home1/ngarg3/git-repos/i220a/work/lab10/files$ cd rip
ngarg3@g7-17:/import/linux/home1/ngarg3/git-repos/i220a/work/lab10/files/rip$ mmake[K[K[K[Kake
cc -Wall -Og -std=c11 -S rip.c
cc -Wall -Og -std=c11    rip.c   -o rip
objdump -d rip > rip.dump
ngarg3@g7-17:/import/linux/home1/ngarg3/git-repos/i220a/work/lab10/files/rip$ ./rip
&get_rip() = 0x561737ebe135; rip = 0x561737ebe13c
ngarg3@g7-17:/import/linux/home1/ngarg3/git-repos/i220a/work/lab10/files/rip$ __asm__("leaq (%%rip), %0": =r(rip));
bash: syntax error near unexpected token `"leaq (%%rip), %0":'
ngarg3@g7-17:/import/linux/home1/ngarg3/git-repos/i220a/work/lab10/files/rip$ 
ngarg3@g7-17:/import/linux/home1/ngarg3/git-repos/i220a/work/lab10/files/rip$ cd ..
ngarg3@g7-17:/import/linux/home1/ngarg3/git-repos/i220a/work/lab10/files$ cd rsp
ngarg3@g7-17:/import/linux/home1/ngarg3/git-repos/i220a/work/lab10/files/rsp$ make
cc -Wall -Og -std=c11 -S rsp.c
[01m[Krsp.c:[m[K In function ‘[01m[Kget_rsp[m[K’:
[01m[Krsp.c:9:10:[m[K [01;35m[Kwarning: [m[K‘[01m[Krsp[m[K’ is used uninitialized in this function [[01;35m[K-Wuninitialized[m[K]
   return [01;35m[Krsp[m[K;
          [01;35m[K^~~[m[K
cc -Wall -Og -std=c11    rsp.c   -o rsp
[01m[Krsp.c:[m[K In function ‘[01m[Kget_rsp[m[K’:
[01m[Krsp.c:9:10:[m[K [01;35m[Kwarning: [m[K‘[01m[Krsp[m[K’ is used uninitialized in this function [[01;35m[K-Wuninitialized[m[K]
   return [01;35m[Krsp[m[K;
          [01;35m[K^~~[m[K
objdump -d rsp > rsp.dump
ngarg3@g7-17:/import/linux/home1/ngarg3/git-repos/i220a/work/lab10/files/rsp$ make
cc -Wall -Og -std=c11 -S rsp.c
[01m[Krsp.c:[m[K In function ‘[01m[Kget_rsp[m[K’:
[01m[Krsp.c:9:30:[m[K [01;31m[Kerror: [m[Kexpected string literal before ‘[01m[K=[m[K’ token
  __asm__("leaq (%%rsp), %0": [01;31m[K=[m[Kr(rsp));
                              [01;31m[K^[m[K
make: *** [Makefile:15: rsp.s] Error 1
ngarg3@g7-17:/import/linux/home1/ngarg3/git-repos/i220a/work/lab10/files/rsp$ make
cc -Wall -Og -std=c11 -S rsp.c
[01m[Krsp.c:[m[K In function ‘[01m[Kget_rsp[m[K’:
[01m[Krsp.c:9:32:[m[K [01;31m[Kerror: [m[Kexpected ‘[01m[K:[m[K’ or ‘[01m[K)[m[K’ before ‘[01m[K([m[K’ token
  __asm__("leaq (%%rsp), %0: =r"[01;31m[K([m[Krsp));
                                [01;31m[K^[m[K
make: *** [Makefile:15: rsp.s] Error 1
ngarg3@g7-17:/import/linux/home1/ngarg3/git-repos/i220a/work/lab10/files/rsp$ make
cc -Wall -Og -std=c11 -S rsp.c
cc -Wall -Og -std=c11    rsp.c   -o rsp
objdump -d rsp > rsp.dump
ngarg3@g7-17:/import/linux/home1/ngarg3/git-repos/i220a/work/lab10/files/rsp$ ./ma[K[Krsp
&stkVar = 0x7fff0eb63b8c; rsp = 0x7fff0eb63b78
ngarg3@g7-17:/import/linux/home1/ngarg3/git-repos/i220a/work/lab10/files/rsp$ cd ..
ngarg3@g7-17:/import/linux/home1/ngarg3/git-repos/i220a/work/lab10/files$ cd ..
ngarg3@g7-17:/import/linux/home1/ngarg3/git-repos/i220a/work/lab10$ gitcd [K[K[K[K[K[Kcd ~i220a
bash: cd: ~i220a: No such file or directory
ngarg3@g7-17:/import/linux/home1/ngarg3/git-repos/i220a/work/lab10$ cd ..
ngarg3@g7-17:/import/linux/home1/ngarg3/git-repos/i220a/work$ cd ..
ngarg3@g7-17:/import/linux/home1/ngarg3/git-repos/i220a$ git mv work?[K/lab10 sun[Kbmit
fatal: source directory is empty, source=work/lab10, destination=submit/lab10
ngarg3@g7-17:/import/linux/home1/ngarg3/git-repos/i220a$ git commit - [Ka -m "sumit[K[Kbmitted lab10"[1P
On branch master
Your branch is up to date with 'origin/master'.

Untracked files:
	[31mwork/bomb29/[m
	[31mwork/lab10/[m

nothing added to commit but untracked files present
ngarg3@g7-17:/import/linux/home1/ngarg3/git-repos/i220a$ git commit -a -m "submitted lab10"[10Pmv work/lab10 submit
fatal: source directory is empty, source=work/lab10, destination=submit/lab10
ngarg3@g7-17:/import/linux/home1/ngarg3/git-repos/i220a$ git add -A
ngarg3@g7-17:/import/linux/home1/ngarg3/git-repos/i220a$ git add -Amv work/lab10 submitcommit -a -m "submitted lab10"
[master 54bf2a0] submitted lab10
 27 files changed, 741 insertions(+)
 create mode 100644 submit/lab10/files/cpuid1/.gitignore
 create mode 100644 submit/lab10/files/cpuid1/Makefile
 create mode 100644 submit/lab10/files/cpuid1/cpuid.s
 create mode 100644 submit/lab10/files/cpuid1/main.c
 create mode 100644 submit/lab10/files/cpuid2/.gitignore
 create mode 100644 submit/lab10/files/cpuid2/Makefile
 create mode 100644 submit/lab10/files/cpuid2/cpuid.s
 create mode 100644 submit/lab10/files/cpuid2/main.c
 create mode 100644 submit/lab10/files/lab10.log
 create mode 100644 submit/lab10/files/lab10_output.txt
 create mode 100644 submit/lab10/files/parity/Makefile
 create mode 100644 submit/lab10/files/parity/main.c
 create mode 100755 submit/lab10/files/parity/parity
 create mode 100644 submit/lab10/files/parity/parity.s
 create mode 100644 submit/lab10/files/rip/.gitignore
 create mode 100644 submit/lab10/files/rip/Makefile
 create mode 100644 submit/lab10/files/rip/rip.c
 create mode 100644 submit/lab10/files/rotate/.gitignore
 create mode 100644 submit/lab10/files/rotate/Makefile
 create mode 100644 submit/lab10/files/rotate/rotate.c
 create mode 100644 submit/lab10/files/rsp/.gitignore
 create mode 100644 submit/lab10/files/rsp/Makefile
 create mode 100644 submit/lab10/files/rsp/rsp.c
 create mode 100644 work/bomb29/README
 create mode 100644 work/bomb29/bomb
 create mode 100644 work/bomb29/bomb.c
 create mode 100644 work/bomb29/bomb.objdump
ngarg3@g7-17:/import/linux/home1/ngarg3/git-repos/i220a$ git push
Username for 'https://github.com': NamanGarg20
Password for 'https://NamanGarg20@github.com': 
remote: Invalid username or password.
fatal: Authentication failed for 'https://github.com/NamanGarg20/i220a.git/'
ngarg3@g7-17:/import/linux/home1/ngarg3/git-repos/i220a$ git push
Username for 'https://github.com': NamanGarg20
Password for 'https://NamanGarg20@github.com': 
Enumerating objects: 42, done.
Counting objects:   2% (1/42)   Counting objects:   4% (2/42)   Counting objects:   7% (3/42)   Counting objects:   9% (4/42)   Counting objects:  11% (5/42)   Counting objects:  14% (6/42)   Counting objects:  16% (7/42)   Counting objects:  19% (8/42)   Counting objects:  21% (9/42)   Counting objects:  23% (10/42)   Counting objects:  26% (11/42)   Counting objects:  28% (12/42)   Counting objects:  30% (13/42)   Counting objects:  33% (14/42)   Counting objects:  35% (15/42)   Counting objects:  38% (16/42)   Counting objects:  40% (17/42)   Counting objects:  42% (18/42)   Counting objects:  45% (19/42)   Counting objects:  47% (20/42)   Counting objects:  50% (21/42)   Counting objects:  52% (22/42)   Counting objects:  54% (23/42)   Counting objects:  57% (24/42)   Counting objects:  59% (25/42)   Counting objects:  61% (26/42)   Counting objects:  64% (27/42)   Counting objects:  66% (28/42)   Counting objects:  69% (29/42)   Counting objects:  71% (30/42)   Counting objects:  73% (31/42)   Counting objects:  76% (32/42)   Counting objects:  78% (33/42)   Counting objects:  80% (34/42)   Counting objects:  83% (35/42)   Counting objects:  85% (36/42)   Counting objects:  88% (37/42)   Counting objects:  90% (38/42)   Counting objects:  92% (39/42)   Counting objects:  95% (40/42)   Counting objects:  97% (41/42)   Counting objects: 100% (42/42)   Counting objects: 100% (42/42), done.
Delta compression using up to 8 threads
Compressing objects:   2% (1/34)   Compressing objects:   5% (2/34)   Compressing objects:   8% (3/34)   Compressing objects:  11% (4/34)   Compressing objects:  14% (5/34)   Compressing objects:  17% (6/34)   Compressing objects:  20% (7/34)   Compressing objects:  23% (8/34)   Compressing objects:  26% (9/34)   Compressing objects:  29% (10/34)   Compressing objects:  32% (11/34)   Compressing objects:  35% (12/34)   Compressing objects:  38% (13/34)   Compressing objects:  41% (14/34)   Compressing objects:  44% (15/34)   Compressing objects:  47% (16/34)   Compressing objects:  50% (17/34)   Compressing objects:  52% (18/34)   Compressing objects:  55% (19/34)   Compressing objects:  58% (20/34)   Compressing objects:  61% (21/34)   Compressing objects:  64% (22/34)   Compressing objects:  67% (23/34)   Compressing objects:  70% (24/34)   Compressing objects:  73% (25/34)   Compressing objects:  76% (26/34)   Compressing objects:  79% (27/34)   Compressing objects:  82% (28/34)   Compressing objects:  85% (29/34)   Compressing objects:  88% (30/34)   Compressing objects:  91% (31/34)   Compressing objects:  94% (32/34)   Compressing objects:  97% (33/34)   Compressing objects: 100% (34/34)   Compressing objects: 100% (34/34), done.
Writing objects:   2% (1/39)   Writing objects:   5% (2/39)   Writing objects:   7% (3/39)   Writing objects:  10% (4/39)   Writing objects:  12% (5/39)   Writing objects:  15% (6/39)   Writing objects:  17% (7/39)   Writing objects:  23% (9/39)   Writing objects:  28% (11/39)   Writing objects:  33% (13/39)   Writing objects:  35% (14/39)   Writing objects:  38% (15/39)   Writing objects:  41% (16/39)   Writing objects:  43% (17/39)   Writing objects:  46% (18/39)   Writing objects:  48% (19/39)   Writing objects:  51% (20/39)   Writing objects:  53% (21/39)   Writing objects:  56% (22/39)   Writing objects:  58% (23/39)   Writing objects:  64% (25/39)   Writing objects:  66% (26/39)   Writing objects:  69% (27/39)   Writing objects:  71% (28/39)   Writing objects:  74% (29/39)   Writing objects:  76% (30/39)   Writing objects:  79% (31/39)   Writing objects:  82% (32/39)   Writing objects:  84% (33/39)   Writing objects:  87% (34/39)   Writing objects:  89% (35/39)   Writing objects:  92% (36/39)   Writing objects:  94% (37/39)   Writing objects:  97% (38/39)   Writing objects: 100% (39/39)   Writing objects: 100% (39/39), 26.15 KiB | 2.38 MiB/s, done.
Total 39 (delta 6), reused 0 (delta 0)
remote: Resolving deltas:   0% (0/6)[Kremote: Resolving deltas:  16% (1/6)[Kremote: Resolving deltas:  33% (2/6)[Kremote: Resolving deltas:  50% (3/6)[Kremote: Resolving deltas:  66% (4/6)[Kremote: Resolving deltas:  83% (5/6)[Kremote: Resolving deltas: 100% (6/6)[Kremote: Resolving deltas: 100% (6/6), completed with 2 local objects.[K
To https://github.com/NamanGarg20/i220a.git
   ce7144e..54bf2a0  master -> master
ngarg3@g7-17:/import/linux/home1/ngarg3/git-repos/i220a$ q
bash: q: command not found
ngarg3@g7-17:/import/linux/home1/ngarg3/git-repos/i220a$ quit
bash: quit: command not found
ngarg3@g7-17:/import/linux/home1/ngarg3/git-repos/i220a$ exit
exit

Script done on 2019-10-24 12:36:16-04:00 [COMMAND_EXIT_CODE="127"]
